District,Male,Female,Children,Total Population,Total Crop Area (in Hect.),Population and Crop Area Details
,Cachar,25330,25580,16120,67030,0
,Darrang,0,0,0,0,0
,Dhemaji,9918,9358,6671,25947,1032.9
,Dibrugarh,1570,1237,1050,3857,67
,Goalpara,0,0,0,0,0
,Kamrup,2,2,4,8,524.9
,Karimganj,10507,9026,7702,27235,0
,Lakhimpur,0,0,0,0,86.47
,Sonitpur,0,0,0,0,0
,Tinsukia,4058,3597,2213,9868,2402
,Udalguri,0,0,0,0,0
,Total,51385,48800,33760,133945,4113.27
