District,Male,Female,Children,Total Population,Total Crop Area (in Hect.),Population and Crop Area Details
,Barpeta,401,511,197,1109,0
,Bongaigao n,0,0,0,0,446
,Chirang,0,0,0,0,0
,Darrang,250,231,8,489,6
,Dhemaji,1531,1415,675,3621,45.7
,Goalpara,7,7,0,14,0
,Hojai,0,0,0,0,61
,Karimganj,39463,32410,23442,95315,0
,Lakhimpur,0,0,0,0,0
,Nagaon,1837,1970,1175,4982,388
,Nalbari,7,9,4,20,0
,Tamulpur,0,0,0,0,59
,Udalguri,0,0,0,0,0
,Total,43606,36642,25538,105786,1005.7
